GGGGG00GGGG
0GGGGGGGGG0
GGGGGGGGGGG
MMGGGGMMMMM
GMMMMMMGGGG
GGGGGGGGGGG