GGGG00GGGGD
GGGGDDGGGDG
GGGGDDGGGGG
GGGGDDGGGGG
GDGGDDGGGGG
DGGGDDGGGGG