GGGGGGGGGGG
GGGGDDDDDDD
GGGGDDDDDDD
GGGGDDGGGGG
GGGGDDGGGGG
GGGGDDGGGGG
