GGGGGGGGGMM
GGGGGGGGGMM
GGGGGGGGGGG
GGGGGGGGGGG
GGGGGDDDGGG
GGGGGGGGGGG
