GGGGGGGGGGG
GGGGGGGGGGG
GGGGGDDGGGG
GGGGDDDDGGG
GGGGGDDGGGG
GGGGGGGGGGG
