GGGGGGGGGGG
GGGGGGGGGGG
MMMMMMGGGGG
MMMMMMGGGGG
GGGGMMGGGGG
GGGGMMGGGGG
