GGGGG00GGGG
0GGGGDDGGG0
MMMMGDDGGGM
GGGMMPHMMMM
GGGGDDDGGGG
GGGGDDGGGGG