GGGGG00GGGD
GGGGGDDGGDG
GGGGGDDGGGG
GGGGGDDGGGG
GDGGGDDGGGG
DGGGGDDGGGG