GGMGG00GMGD
GGGGGMDGGDG
GMGGGDDGGGG
GGGGGDDGDGG
GDGMGDDGMMG
DGGGGDDMGGG